########
#000000#
#000000#
#0#00#0#
#0#.0#0#
#0#0.#0#
#0.00.0#
#000000#
########


p01 01 

c02 03 
c02 04 
c06 03 
c06 04 