########
#000000#
#00..00#
#0.0000#
#00..00#
#0000.0#
#00..00#
#000000#
########

p01 01 

c02 02 
c03 03 
c03 04 
c04 02 
c04 05 
c05 03 
c05 04 
c06 05