########
#000000#
#0.00.0#
#0#0.00#
#0#.000#
#0#0.00#
#0.00.0#
#000000#
########

p01 01 

c02 03 
c02 04 
c03 05 
c04 05 
c05 05 
c06 04 
c06 03 