########
#000000#
#0..000#
#00.000#
#00#000#
#00.0#0#
#0#..#0#
#000000#
########

p01 01 

c03 02 
c03 05 
c04 02 
c04 05 
c05 02 
c05 04 