########
#000000#
#0...#0#
#0.0.00#
#0..#00#
#0.0.00#
#0.0.#0#
#000000#
########

p01 01 

c02 03 
c02 04 
c03 04 
c05 04 
c06 02 
c06 03 
c06 04 
c02 02 
c04 02 
c05 02 
c04 05 