 #######
 #00000###
##0###000#
#00000000#
#0..#000##
##..#000#
 ########

p04 01 

c02 02 
c03 04 
c03 07 
c04 06 