  ###
  #.#
  #0####
###000.#
#.000###
####0#
   #.#
   ###

p04 04 

c03 03 
c04 03 
c03 05 
c05 04 