########
#000000#
#00#..0#
#000.00#
#000.00#
#000.00#
#00###0#
#000000#
########

p01 01 

c02 02 
c03 03 
c04 03 
c05 03 
c05 05 