########
#000000#
#0#..00#
#0#0000#
#0#.000#
#0#0000#
#0...00#
#000000#
########

p01 01 

c02 05 
c03 03 
c03 05 
c04 04 
c04 05 
c05 05 