########
#000000#
#0#00.0#
#00..00#
#0#00.0#
#00..00#
#0#00.0#
#000000#
########

p01 01 

c02 03 
c02 04 
c03 02 
c04 03 
c05 02 
c06 03 
c06 04 
