         ########
         #000000#
         #00#00##
         #00000#
         ##0000#
##########000#0###
#..0000###0000000#
##..0000000000000#
#..0000###########
########

p01 12 

c02 11 
c04 11 
c04 12 
c04 13 
c06 10 
c06 14 