########
#000000#
#0.00.0#
#00..00#
#0.00.0#
#000.00#
#0.00.0#
#00.000#
########
p01 01 

c02 02 
c02 05 
c03 02 
c03 03 
c03 05 
c04 05 
c04 02 
c06 03 
c06 04 
c05 05 