########
#000000#
#0.0000#
#000.00#
#00.000#
#000.00#
#0.0000#
#000000#
########
p01 01 

c03 03 
c02 03 
c02 05 
c05 03 
c06 03 