########
#000000#
#000.00#
#00.0.0#
#000..0#
#00.0.0#
#0000.0#
#000000#
########
p01 01 

c02 02 
c03 02 
c02 03 
c03 04 
c04 02 
c05 02 
c06 02 
c05 04 