########
#000000#
#0.00.0#
#0..0.0#
#0.0..0#
#0.0000#
#000000#
#000000#
########
p01 01 

c02 04 
c04 03 
c05 03 
c06 03 
c06 05 
c03 03 
c03 05 
c04 04 
c04 05 