########
#000000#
#00##00#
#0#00.0#
#0.00.0#
#0.00#0#
#00##00#
#000000#
########

p01 01 

c02 06 
c03 03 
c03 04 
c05 02 